"filename", "language", "CSS", "JavaScript", "XML", "PHP", "Log", "comment", "blank", "total"
"c:\xampp\htdocs\JobRadar\Components\employeur\Presentation\annonce.php", "PHP", 0, 0, 0, 166, 0, 1, 5, 172
"c:\xampp\htdocs\JobRadar\Components\employeur\Presentation\entreprise.php", "PHP", 0, 0, 0, 12, 0, 0, 5, 17
"c:\xampp\htdocs\JobRadar\Components\employeur\Presentation\publication.php", "PHP", 0, 0, 0, 322, 0, 12, 43, 377
"c:\xampp\htdocs\JobRadar\Components\employeur\header.php", "PHP", 0, 0, 0, 6, 0, 1, 0, 7
"c:\xampp\htdocs\JobRadar\Components\employeur\index.php", "PHP", 0, 0, 0, -5, 0, 0, 1, -4
"c:\xampp\htdocs\JobRadar\api\employeur\annonce\selectAllAnnonce.php", "PHP", 0, 0, 0, 11, 0, 3, 0, 14
"c:\xampp\htdocs\JobRadar\api\employeur\entreprise\del_piece_jointe.php", "PHP", 0, 0, 0, 56, 0, 3, 3, 62
"c:\xampp\htdocs\JobRadar\api\employeur\entreprise\delete_ent.php", "PHP", 0, 0, 0, 7, 0, 0, 0, 7
"c:\xampp\htdocs\JobRadar\api\error.log", "Log", 0, 0, 0, 0, 18, 0, 1, 19
"c:\xampp\htdocs\JobRadar\public\like.svg", "XML", 0, 0, 4, 0, 0, 0, 0, 4
"c:\xampp\htdocs\JobRadar\public\like_ok.svg", "XML", 0, 0, 5, 0, 0, 0, 0, 5
"c:\xampp\htdocs\JobRadar\script\chomeur\index.js", "JavaScript", 0, 85, 0, 0, 0, 13, 12, 110
"c:\xampp\htdocs\JobRadar\script\employeur\index.js", "JavaScript", 0, 85, 0, 0, 0, 13, 12, 110
"c:\xampp\htdocs\JobRadar\style\chomeur\presentation_ent.css", "CSS", -3, 0, 0, 0, 0, 0, -1, -4
"c:\xampp\htdocs\JobRadar\style\chomeur\presentation_exp.css", "CSS", -3, 0, 0, 0, 0, 0, 0, -3
"c:\xampp\htdocs\JobRadar\style\employeur\presentation_ent.css", "CSS", 32, 0, 0, 0, 0, 0, 0, 32
"Total", "-", 26, 170, 9, 575, 18, 46, 81, 925